,TeamName,Year,Wins,Losses,OTLosses,Win%,GoalsFor(GF),GoalsAgainst(GA),+/-
0,BostonBruins,1990,44,24,,0.55,299,264,35
1,BuffaloSabres,1990,31,30,,0.388,292,278,14
2,CalgaryFlames,1990,46,26,,0.575,344,263,81
3,ChicagoBlackhawks,1990,49,23,,0.613,284,211,73
4,DetroitRedWings,1990,34,38,,0.425,273,298,-25
5,EdmontonOilers,1990,37,37,,0.463,272,272,0
6,HartfordWhalers,1990,31,38,,0.388,238,276,-38
7,LosAngelesKings,1990,46,24,,0.575,340,254,86
8,MinnesotaNorthStars,1990,27,39,,0.338,256,266,-10
9,MontrealCanadiens,1990,39,30,,0.487,273,249,24
10,NewJerseyDevils,1990,32,33,,0.4,272,264,8
11,NewYorkIslanders,1990,25,45,,0.312,223,290,-67
12,NewYorkRangers,1990,36,31,,0.45,297,265,32
13,PhiladelphiaFlyers,1990,33,37,,0.412,252,267,-15
14,PittsburghPenguins,1990,41,33,,0.512,342,305,37
15,QuebecNordiques,1990,16,50,,0.2,236,354,-118
16,St.LouisBlues,1990,47,22,,0.588,310,250,60
17,TorontoMapleLeafs,1990,23,46,,0.287,241,318,-77
18,VancouverCanucks,1990,28,43,,0.35,243,315,-72
19,WashingtonCapitals,1990,37,36,,0.463,258,258,0
20,WinnipegJets,1990,26,43,,0.325,260,288,-28
21,BostonBruins,1991,36,32,,0.45,270,275,-5
22,BuffaloSabres,1991,31,37,,0.388,289,299,-10
23,CalgaryFlames,1991,31,37,,0.388,296,305,-9
24,ChicagoBlackhawks,1991,36,29,,0.45,257,236,21
25,BostonBruins,1990,44,24,,0.55,299,264,35
26,BuffaloSabres,1990,31,30,,0.388,292,278,14
27,CalgaryFlames,1990,46,26,,0.575,344,263,81
28,ChicagoBlackhawks,1990,49,23,,0.613,284,211,73
29,DetroitRedWings,1990,34,38,,0.425,273,298,-25
30,EdmontonOilers,1990,37,37,,0.463,272,272,0
31,HartfordWhalers,1990,31,38,,0.388,238,276,-38
32,LosAngelesKings,1990,46,24,,0.575,340,254,86
33,MinnesotaNorthStars,1990,27,39,,0.338,256,266,-10
34,MontrealCanadiens,1990,39,30,,0.487,273,249,24
35,NewJerseyDevils,1990,32,33,,0.4,272,264,8
36,NewYorkIslanders,1990,25,45,,0.312,223,290,-67
37,NewYorkRangers,1990,36,31,,0.45,297,265,32
38,PhiladelphiaFlyers,1990,33,37,,0.412,252,267,-15
39,PittsburghPenguins,1990,41,33,,0.512,342,305,37
40,QuebecNordiques,1990,16,50,,0.2,236,354,-118
41,St.LouisBlues,1990,47,22,,0.588,310,250,60
42,TorontoMapleLeafs,1990,23,46,,0.287,241,318,-77
43,VancouverCanucks,1990,28,43,,0.35,243,315,-72
44,WashingtonCapitals,1990,37,36,,0.463,258,258,0
45,WinnipegJets,1990,26,43,,0.325,260,288,-28
46,BostonBruins,1991,36,32,,0.45,270,275,-5
47,BuffaloSabres,1991,31,37,,0.388,289,299,-10
48,CalgaryFlames,1991,31,37,,0.388,296,305,-9
49,ChicagoBlackhawks,1991,36,29,,0.45,257,236,21
50,BostonBruins,1990,44,24,,0.55,299,264,35
51,BuffaloSabres,1990,31,30,,0.388,292,278,14
52,CalgaryFlames,1990,46,26,,0.575,344,263,81
53,ChicagoBlackhawks,1990,49,23,,0.613,284,211,73
54,DetroitRedWings,1990,34,38,,0.425,273,298,-25
55,EdmontonOilers,1990,37,37,,0.463,272,272,0
56,HartfordWhalers,1990,31,38,,0.388,238,276,-38
57,LosAngelesKings,1990,46,24,,0.575,340,254,86
58,MinnesotaNorthStars,1990,27,39,,0.338,256,266,-10
59,MontrealCanadiens,1990,39,30,,0.487,273,249,24
60,NewJerseyDevils,1990,32,33,,0.4,272,264,8
61,NewYorkIslanders,1990,25,45,,0.312,223,290,-67
62,NewYorkRangers,1990,36,31,,0.45,297,265,32
63,PhiladelphiaFlyers,1990,33,37,,0.412,252,267,-15
64,PittsburghPenguins,1990,41,33,,0.512,342,305,37
65,QuebecNordiques,1990,16,50,,0.2,236,354,-118
66,St.LouisBlues,1990,47,22,,0.588,310,250,60
67,TorontoMapleLeafs,1990,23,46,,0.287,241,318,-77
68,VancouverCanucks,1990,28,43,,0.35,243,315,-72
69,WashingtonCapitals,1990,37,36,,0.463,258,258,0
70,WinnipegJets,1990,26,43,,0.325,260,288,-28
71,BostonBruins,1991,36,32,,0.45,270,275,-5
72,BuffaloSabres,1991,31,37,,0.388,289,299,-10
73,CalgaryFlames,1991,31,37,,0.388,296,305,-9
74,ChicagoBlackhawks,1991,36,29,,0.45,257,236,21
75,BostonBruins,1990,44,24,,0.55,299,264,35
76,BuffaloSabres,1990,31,30,,0.388,292,278,14
77,CalgaryFlames,1990,46,26,,0.575,344,263,81
78,ChicagoBlackhawks,1990,49,23,,0.613,284,211,73
79,DetroitRedWings,1990,34,38,,0.425,273,298,-25
80,EdmontonOilers,1990,37,37,,0.463,272,272,0
81,HartfordWhalers,1990,31,38,,0.388,238,276,-38
82,LosAngelesKings,1990,46,24,,0.575,340,254,86
83,MinnesotaNorthStars,1990,27,39,,0.338,256,266,-10
84,MontrealCanadiens,1990,39,30,,0.487,273,249,24
85,NewJerseyDevils,1990,32,33,,0.4,272,264,8
86,NewYorkIslanders,1990,25,45,,0.312,223,290,-67
87,NewYorkRangers,1990,36,31,,0.45,297,265,32
88,PhiladelphiaFlyers,1990,33,37,,0.412,252,267,-15
89,PittsburghPenguins,1990,41,33,,0.512,342,305,37
90,QuebecNordiques,1990,16,50,,0.2,236,354,-118
91,St.LouisBlues,1990,47,22,,0.588,310,250,60
92,TorontoMapleLeafs,1990,23,46,,0.287,241,318,-77
93,VancouverCanucks,1990,28,43,,0.35,243,315,-72
94,WashingtonCapitals,1990,37,36,,0.463,258,258,0
95,WinnipegJets,1990,26,43,,0.325,260,288,-28
96,BostonBruins,1991,36,32,,0.45,270,275,-5
97,BuffaloSabres,1991,31,37,,0.388,289,299,-10
98,CalgaryFlames,1991,31,37,,0.388,296,305,-9
99,ChicagoBlackhawks,1991,36,29,,0.45,257,236,21
100,BostonBruins,1990,44,24,,0.55,299,264,35
101,BuffaloSabres,1990,31,30,,0.388,292,278,14
102,CalgaryFlames,1990,46,26,,0.575,344,263,81
103,ChicagoBlackhawks,1990,49,23,,0.613,284,211,73
104,DetroitRedWings,1990,34,38,,0.425,273,298,-25
105,EdmontonOilers,1990,37,37,,0.463,272,272,0
106,HartfordWhalers,1990,31,38,,0.388,238,276,-38
107,LosAngelesKings,1990,46,24,,0.575,340,254,86
108,MinnesotaNorthStars,1990,27,39,,0.338,256,266,-10
109,MontrealCanadiens,1990,39,30,,0.487,273,249,24
110,NewJerseyDevils,1990,32,33,,0.4,272,264,8
111,NewYorkIslanders,1990,25,45,,0.312,223,290,-67
112,NewYorkRangers,1990,36,31,,0.45,297,265,32
113,PhiladelphiaFlyers,1990,33,37,,0.412,252,267,-15
114,PittsburghPenguins,1990,41,33,,0.512,342,305,37
115,QuebecNordiques,1990,16,50,,0.2,236,354,-118
116,St.LouisBlues,1990,47,22,,0.588,310,250,60
117,TorontoMapleLeafs,1990,23,46,,0.287,241,318,-77
118,VancouverCanucks,1990,28,43,,0.35,243,315,-72
119,WashingtonCapitals,1990,37,36,,0.463,258,258,0
120,WinnipegJets,1990,26,43,,0.325,260,288,-28
121,BostonBruins,1991,36,32,,0.45,270,275,-5
122,BuffaloSabres,1991,31,37,,0.388,289,299,-10
123,CalgaryFlames,1991,31,37,,0.388,296,305,-9
124,ChicagoBlackhawks,1991,36,29,,0.45,257,236,21
125,BostonBruins,1990,44,24,,0.55,299,264,35
126,BuffaloSabres,1990,31,30,,0.388,292,278,14
127,CalgaryFlames,1990,46,26,,0.575,344,263,81
128,ChicagoBlackhawks,1990,49,23,,0.613,284,211,73
129,DetroitRedWings,1990,34,38,,0.425,273,298,-25
130,EdmontonOilers,1990,37,37,,0.463,272,272,0
131,HartfordWhalers,1990,31,38,,0.388,238,276,-38
132,LosAngelesKings,1990,46,24,,0.575,340,254,86
133,MinnesotaNorthStars,1990,27,39,,0.338,256,266,-10
134,MontrealCanadiens,1990,39,30,,0.487,273,249,24
135,NewJerseyDevils,1990,32,33,,0.4,272,264,8
136,NewYorkIslanders,1990,25,45,,0.312,223,290,-67
137,NewYorkRangers,1990,36,31,,0.45,297,265,32
138,PhiladelphiaFlyers,1990,33,37,,0.412,252,267,-15
139,PittsburghPenguins,1990,41,33,,0.512,342,305,37
140,QuebecNordiques,1990,16,50,,0.2,236,354,-118
141,St.LouisBlues,1990,47,22,,0.588,310,250,60
142,TorontoMapleLeafs,1990,23,46,,0.287,241,318,-77
143,VancouverCanucks,1990,28,43,,0.35,243,315,-72
144,WashingtonCapitals,1990,37,36,,0.463,258,258,0
145,WinnipegJets,1990,26,43,,0.325,260,288,-28
146,BostonBruins,1991,36,32,,0.45,270,275,-5
147,BuffaloSabres,1991,31,37,,0.388,289,299,-10
148,CalgaryFlames,1991,31,37,,0.388,296,305,-9
149,ChicagoBlackhawks,1991,36,29,,0.45,257,236,21
150,BostonBruins,1990,44,24,,0.55,299,264,35
151,BuffaloSabres,1990,31,30,,0.388,292,278,14
152,CalgaryFlames,1990,46,26,,0.575,344,263,81
153,ChicagoBlackhawks,1990,49,23,,0.613,284,211,73
154,DetroitRedWings,1990,34,38,,0.425,273,298,-25
155,EdmontonOilers,1990,37,37,,0.463,272,272,0
156,HartfordWhalers,1990,31,38,,0.388,238,276,-38
157,LosAngelesKings,1990,46,24,,0.575,340,254,86
158,MinnesotaNorthStars,1990,27,39,,0.338,256,266,-10
159,MontrealCanadiens,1990,39,30,,0.487,273,249,24
160,NewJerseyDevils,1990,32,33,,0.4,272,264,8
161,NewYorkIslanders,1990,25,45,,0.312,223,290,-67
162,NewYorkRangers,1990,36,31,,0.45,297,265,32
163,PhiladelphiaFlyers,1990,33,37,,0.412,252,267,-15
164,PittsburghPenguins,1990,41,33,,0.512,342,305,37
165,QuebecNordiques,1990,16,50,,0.2,236,354,-118
166,St.LouisBlues,1990,47,22,,0.588,310,250,60
167,TorontoMapleLeafs,1990,23,46,,0.287,241,318,-77
168,VancouverCanucks,1990,28,43,,0.35,243,315,-72
169,WashingtonCapitals,1990,37,36,,0.463,258,258,0
170,WinnipegJets,1990,26,43,,0.325,260,288,-28
171,BostonBruins,1991,36,32,,0.45,270,275,-5
172,BuffaloSabres,1991,31,37,,0.388,289,299,-10
173,CalgaryFlames,1991,31,37,,0.388,296,305,-9
174,ChicagoBlackhawks,1991,36,29,,0.45,257,236,21
175,BostonBruins,1990,44,24,,0.55,299,264,35
176,BuffaloSabres,1990,31,30,,0.388,292,278,14
177,CalgaryFlames,1990,46,26,,0.575,344,263,81
178,ChicagoBlackhawks,1990,49,23,,0.613,284,211,73
179,DetroitRedWings,1990,34,38,,0.425,273,298,-25
180,EdmontonOilers,1990,37,37,,0.463,272,272,0
181,HartfordWhalers,1990,31,38,,0.388,238,276,-38
182,LosAngelesKings,1990,46,24,,0.575,340,254,86
183,MinnesotaNorthStars,1990,27,39,,0.338,256,266,-10
184,MontrealCanadiens,1990,39,30,,0.487,273,249,24
185,NewJerseyDevils,1990,32,33,,0.4,272,264,8
186,NewYorkIslanders,1990,25,45,,0.312,223,290,-67
187,NewYorkRangers,1990,36,31,,0.45,297,265,32
188,PhiladelphiaFlyers,1990,33,37,,0.412,252,267,-15
189,PittsburghPenguins,1990,41,33,,0.512,342,305,37
190,QuebecNordiques,1990,16,50,,0.2,236,354,-118
191,St.LouisBlues,1990,47,22,,0.588,310,250,60
192,TorontoMapleLeafs,1990,23,46,,0.287,241,318,-77
193,VancouverCanucks,1990,28,43,,0.35,243,315,-72
194,WashingtonCapitals,1990,37,36,,0.463,258,258,0
195,WinnipegJets,1990,26,43,,0.325,260,288,-28
196,BostonBruins,1991,36,32,,0.45,270,275,-5
197,BuffaloSabres,1991,31,37,,0.388,289,299,-10
198,CalgaryFlames,1991,31,37,,0.388,296,305,-9
199,ChicagoBlackhawks,1991,36,29,,0.45,257,236,21
200,BostonBruins,1990,44,24,,0.55,299,264,35
201,BuffaloSabres,1990,31,30,,0.388,292,278,14
202,CalgaryFlames,1990,46,26,,0.575,344,263,81
203,ChicagoBlackhawks,1990,49,23,,0.613,284,211,73
204,DetroitRedWings,1990,34,38,,0.425,273,298,-25
205,EdmontonOilers,1990,37,37,,0.463,272,272,0
206,HartfordWhalers,1990,31,38,,0.388,238,276,-38
207,LosAngelesKings,1990,46,24,,0.575,340,254,86
208,MinnesotaNorthStars,1990,27,39,,0.338,256,266,-10
209,MontrealCanadiens,1990,39,30,,0.487,273,249,24
210,NewJerseyDevils,1990,32,33,,0.4,272,264,8
211,NewYorkIslanders,1990,25,45,,0.312,223,290,-67
212,NewYorkRangers,1990,36,31,,0.45,297,265,32
213,PhiladelphiaFlyers,1990,33,37,,0.412,252,267,-15
214,PittsburghPenguins,1990,41,33,,0.512,342,305,37
215,QuebecNordiques,1990,16,50,,0.2,236,354,-118
216,St.LouisBlues,1990,47,22,,0.588,310,250,60
217,TorontoMapleLeafs,1990,23,46,,0.287,241,318,-77
218,VancouverCanucks,1990,28,43,,0.35,243,315,-72
219,WashingtonCapitals,1990,37,36,,0.463,258,258,0
220,WinnipegJets,1990,26,43,,0.325,260,288,-28
221,BostonBruins,1991,36,32,,0.45,270,275,-5
222,BuffaloSabres,1991,31,37,,0.388,289,299,-10
223,CalgaryFlames,1991,31,37,,0.388,296,305,-9
224,ChicagoBlackhawks,1991,36,29,,0.45,257,236,21
225,BostonBruins,1990,44,24,,0.55,299,264,35
226,BuffaloSabres,1990,31,30,,0.388,292,278,14
227,CalgaryFlames,1990,46,26,,0.575,344,263,81
228,ChicagoBlackhawks,1990,49,23,,0.613,284,211,73
229,DetroitRedWings,1990,34,38,,0.425,273,298,-25
230,EdmontonOilers,1990,37,37,,0.463,272,272,0
231,HartfordWhalers,1990,31,38,,0.388,238,276,-38
232,LosAngelesKings,1990,46,24,,0.575,340,254,86
233,MinnesotaNorthStars,1990,27,39,,0.338,256,266,-10
234,MontrealCanadiens,1990,39,30,,0.487,273,249,24
235,NewJerseyDevils,1990,32,33,,0.4,272,264,8
236,NewYorkIslanders,1990,25,45,,0.312,223,290,-67
237,NewYorkRangers,1990,36,31,,0.45,297,265,32
238,PhiladelphiaFlyers,1990,33,37,,0.412,252,267,-15
239,PittsburghPenguins,1990,41,33,,0.512,342,305,37
240,QuebecNordiques,1990,16,50,,0.2,236,354,-118
241,St.LouisBlues,1990,47,22,,0.588,310,250,60
242,TorontoMapleLeafs,1990,23,46,,0.287,241,318,-77
243,VancouverCanucks,1990,28,43,,0.35,243,315,-72
244,WashingtonCapitals,1990,37,36,,0.463,258,258,0
245,WinnipegJets,1990,26,43,,0.325,260,288,-28
246,BostonBruins,1991,36,32,,0.45,270,275,-5
247,BuffaloSabres,1991,31,37,,0.388,289,299,-10
248,CalgaryFlames,1991,31,37,,0.388,296,305,-9
249,ChicagoBlackhawks,1991,36,29,,0.45,257,236,21
250,BostonBruins,1990,44,24,,0.55,299,264,35
251,BuffaloSabres,1990,31,30,,0.388,292,278,14
252,CalgaryFlames,1990,46,26,,0.575,344,263,81
253,ChicagoBlackhawks,1990,49,23,,0.613,284,211,73
254,DetroitRedWings,1990,34,38,,0.425,273,298,-25
255,EdmontonOilers,1990,37,37,,0.463,272,272,0
256,HartfordWhalers,1990,31,38,,0.388,238,276,-38
257,LosAngelesKings,1990,46,24,,0.575,340,254,86
258,MinnesotaNorthStars,1990,27,39,,0.338,256,266,-10
259,MontrealCanadiens,1990,39,30,,0.487,273,249,24
260,NewJerseyDevils,1990,32,33,,0.4,272,264,8
261,NewYorkIslanders,1990,25,45,,0.312,223,290,-67
262,NewYorkRangers,1990,36,31,,0.45,297,265,32
263,PhiladelphiaFlyers,1990,33,37,,0.412,252,267,-15
264,PittsburghPenguins,1990,41,33,,0.512,342,305,37
265,QuebecNordiques,1990,16,50,,0.2,236,354,-118
266,St.LouisBlues,1990,47,22,,0.588,310,250,60
267,TorontoMapleLeafs,1990,23,46,,0.287,241,318,-77
268,VancouverCanucks,1990,28,43,,0.35,243,315,-72
269,WashingtonCapitals,1990,37,36,,0.463,258,258,0
270,WinnipegJets,1990,26,43,,0.325,260,288,-28
271,BostonBruins,1991,36,32,,0.45,270,275,-5
272,BuffaloSabres,1991,31,37,,0.388,289,299,-10
273,CalgaryFlames,1991,31,37,,0.388,296,305,-9
274,ChicagoBlackhawks,1991,36,29,,0.45,257,236,21
275,BostonBruins,1990,44,24,,0.55,299,264,35
276,BuffaloSabres,1990,31,30,,0.388,292,278,14
277,CalgaryFlames,1990,46,26,,0.575,344,263,81
278,ChicagoBlackhawks,1990,49,23,,0.613,284,211,73
279,DetroitRedWings,1990,34,38,,0.425,273,298,-25
280,EdmontonOilers,1990,37,37,,0.463,272,272,0
281,HartfordWhalers,1990,31,38,,0.388,238,276,-38
282,LosAngelesKings,1990,46,24,,0.575,340,254,86
283,MinnesotaNorthStars,1990,27,39,,0.338,256,266,-10
284,MontrealCanadiens,1990,39,30,,0.487,273,249,24
285,NewJerseyDevils,1990,32,33,,0.4,272,264,8
286,NewYorkIslanders,1990,25,45,,0.312,223,290,-67
287,NewYorkRangers,1990,36,31,,0.45,297,265,32
288,PhiladelphiaFlyers,1990,33,37,,0.412,252,267,-15
289,PittsburghPenguins,1990,41,33,,0.512,342,305,37
290,QuebecNordiques,1990,16,50,,0.2,236,354,-118
291,St.LouisBlues,1990,47,22,,0.588,310,250,60
292,TorontoMapleLeafs,1990,23,46,,0.287,241,318,-77
293,VancouverCanucks,1990,28,43,,0.35,243,315,-72
294,WashingtonCapitals,1990,37,36,,0.463,258,258,0
295,WinnipegJets,1990,26,43,,0.325,260,288,-28
296,BostonBruins,1991,36,32,,0.45,270,275,-5
297,BuffaloSabres,1991,31,37,,0.388,289,299,-10
298,CalgaryFlames,1991,31,37,,0.388,296,305,-9
299,ChicagoBlackhawks,1991,36,29,,0.45,257,236,21
300,BostonBruins,1990,44,24,,0.55,299,264,35
301,BuffaloSabres,1990,31,30,,0.388,292,278,14
302,CalgaryFlames,1990,46,26,,0.575,344,263,81
303,ChicagoBlackhawks,1990,49,23,,0.613,284,211,73
304,DetroitRedWings,1990,34,38,,0.425,273,298,-25
305,EdmontonOilers,1990,37,37,,0.463,272,272,0
306,HartfordWhalers,1990,31,38,,0.388,238,276,-38
307,LosAngelesKings,1990,46,24,,0.575,340,254,86
308,MinnesotaNorthStars,1990,27,39,,0.338,256,266,-10
309,MontrealCanadiens,1990,39,30,,0.487,273,249,24
310,NewJerseyDevils,1990,32,33,,0.4,272,264,8
311,NewYorkIslanders,1990,25,45,,0.312,223,290,-67
312,NewYorkRangers,1990,36,31,,0.45,297,265,32
313,PhiladelphiaFlyers,1990,33,37,,0.412,252,267,-15
314,PittsburghPenguins,1990,41,33,,0.512,342,305,37
315,QuebecNordiques,1990,16,50,,0.2,236,354,-118
316,St.LouisBlues,1990,47,22,,0.588,310,250,60
317,TorontoMapleLeafs,1990,23,46,,0.287,241,318,-77
318,VancouverCanucks,1990,28,43,,0.35,243,315,-72
319,WashingtonCapitals,1990,37,36,,0.463,258,258,0
320,WinnipegJets,1990,26,43,,0.325,260,288,-28
321,BostonBruins,1991,36,32,,0.45,270,275,-5
322,BuffaloSabres,1991,31,37,,0.388,289,299,-10
323,CalgaryFlames,1991,31,37,,0.388,296,305,-9
324,ChicagoBlackhawks,1991,36,29,,0.45,257,236,21
325,BostonBruins,1990,44,24,,0.55,299,264,35
326,BuffaloSabres,1990,31,30,,0.388,292,278,14
327,CalgaryFlames,1990,46,26,,0.575,344,263,81
328,ChicagoBlackhawks,1990,49,23,,0.613,284,211,73
329,DetroitRedWings,1990,34,38,,0.425,273,298,-25
330,EdmontonOilers,1990,37,37,,0.463,272,272,0
331,HartfordWhalers,1990,31,38,,0.388,238,276,-38
332,LosAngelesKings,1990,46,24,,0.575,340,254,86
333,MinnesotaNorthStars,1990,27,39,,0.338,256,266,-10
334,MontrealCanadiens,1990,39,30,,0.487,273,249,24
335,NewJerseyDevils,1990,32,33,,0.4,272,264,8
336,NewYorkIslanders,1990,25,45,,0.312,223,290,-67
337,NewYorkRangers,1990,36,31,,0.45,297,265,32
338,PhiladelphiaFlyers,1990,33,37,,0.412,252,267,-15
339,PittsburghPenguins,1990,41,33,,0.512,342,305,37
340,QuebecNordiques,1990,16,50,,0.2,236,354,-118
341,St.LouisBlues,1990,47,22,,0.588,310,250,60
342,TorontoMapleLeafs,1990,23,46,,0.287,241,318,-77
343,VancouverCanucks,1990,28,43,,0.35,243,315,-72
344,WashingtonCapitals,1990,37,36,,0.463,258,258,0
345,WinnipegJets,1990,26,43,,0.325,260,288,-28
346,BostonBruins,1991,36,32,,0.45,270,275,-5
347,BuffaloSabres,1991,31,37,,0.388,289,299,-10
348,CalgaryFlames,1991,31,37,,0.388,296,305,-9
349,ChicagoBlackhawks,1991,36,29,,0.45,257,236,21
350,BostonBruins,1990,44,24,,0.55,299,264,35
351,BuffaloSabres,1990,31,30,,0.388,292,278,14
352,CalgaryFlames,1990,46,26,,0.575,344,263,81
353,ChicagoBlackhawks,1990,49,23,,0.613,284,211,73
354,DetroitRedWings,1990,34,38,,0.425,273,298,-25
355,EdmontonOilers,1990,37,37,,0.463,272,272,0
356,HartfordWhalers,1990,31,38,,0.388,238,276,-38
357,LosAngelesKings,1990,46,24,,0.575,340,254,86
358,MinnesotaNorthStars,1990,27,39,,0.338,256,266,-10
359,MontrealCanadiens,1990,39,30,,0.487,273,249,24
360,NewJerseyDevils,1990,32,33,,0.4,272,264,8
361,NewYorkIslanders,1990,25,45,,0.312,223,290,-67
362,NewYorkRangers,1990,36,31,,0.45,297,265,32
363,PhiladelphiaFlyers,1990,33,37,,0.412,252,267,-15
364,PittsburghPenguins,1990,41,33,,0.512,342,305,37
365,QuebecNordiques,1990,16,50,,0.2,236,354,-118
366,St.LouisBlues,1990,47,22,,0.588,310,250,60
367,TorontoMapleLeafs,1990,23,46,,0.287,241,318,-77
368,VancouverCanucks,1990,28,43,,0.35,243,315,-72
369,WashingtonCapitals,1990,37,36,,0.463,258,258,0
370,WinnipegJets,1990,26,43,,0.325,260,288,-28
371,BostonBruins,1991,36,32,,0.45,270,275,-5
372,BuffaloSabres,1991,31,37,,0.388,289,299,-10
373,CalgaryFlames,1991,31,37,,0.388,296,305,-9
374,ChicagoBlackhawks,1991,36,29,,0.45,257,236,21
375,BostonBruins,1990,44,24,,0.55,299,264,35
376,BuffaloSabres,1990,31,30,,0.388,292,278,14
377,CalgaryFlames,1990,46,26,,0.575,344,263,81
378,ChicagoBlackhawks,1990,49,23,,0.613,284,211,73
379,DetroitRedWings,1990,34,38,,0.425,273,298,-25
380,EdmontonOilers,1990,37,37,,0.463,272,272,0
381,HartfordWhalers,1990,31,38,,0.388,238,276,-38
382,LosAngelesKings,1990,46,24,,0.575,340,254,86
383,MinnesotaNorthStars,1990,27,39,,0.338,256,266,-10
384,MontrealCanadiens,1990,39,30,,0.487,273,249,24
385,NewJerseyDevils,1990,32,33,,0.4,272,264,8
386,NewYorkIslanders,1990,25,45,,0.312,223,290,-67
387,NewYorkRangers,1990,36,31,,0.45,297,265,32
388,PhiladelphiaFlyers,1990,33,37,,0.412,252,267,-15
389,PittsburghPenguins,1990,41,33,,0.512,342,305,37
390,QuebecNordiques,1990,16,50,,0.2,236,354,-118
391,St.LouisBlues,1990,47,22,,0.588,310,250,60
392,TorontoMapleLeafs,1990,23,46,,0.287,241,318,-77
393,VancouverCanucks,1990,28,43,,0.35,243,315,-72
394,WashingtonCapitals,1990,37,36,,0.463,258,258,0
395,WinnipegJets,1990,26,43,,0.325,260,288,-28
396,BostonBruins,1991,36,32,,0.45,270,275,-5
397,BuffaloSabres,1991,31,37,,0.388,289,299,-10
398,CalgaryFlames,1991,31,37,,0.388,296,305,-9
399,ChicagoBlackhawks,1991,36,29,,0.45,257,236,21
400,BostonBruins,1990,44,24,,0.55,299,264,35
401,BuffaloSabres,1990,31,30,,0.388,292,278,14
402,CalgaryFlames,1990,46,26,,0.575,344,263,81
403,ChicagoBlackhawks,1990,49,23,,0.613,284,211,73
404,DetroitRedWings,1990,34,38,,0.425,273,298,-25
405,EdmontonOilers,1990,37,37,,0.463,272,272,0
406,HartfordWhalers,1990,31,38,,0.388,238,276,-38
407,LosAngelesKings,1990,46,24,,0.575,340,254,86
408,MinnesotaNorthStars,1990,27,39,,0.338,256,266,-10
409,MontrealCanadiens,1990,39,30,,0.487,273,249,24
410,NewJerseyDevils,1990,32,33,,0.4,272,264,8
411,NewYorkIslanders,1990,25,45,,0.312,223,290,-67
412,NewYorkRangers,1990,36,31,,0.45,297,265,32
413,PhiladelphiaFlyers,1990,33,37,,0.412,252,267,-15
414,PittsburghPenguins,1990,41,33,,0.512,342,305,37
415,QuebecNordiques,1990,16,50,,0.2,236,354,-118
416,St.LouisBlues,1990,47,22,,0.588,310,250,60
417,TorontoMapleLeafs,1990,23,46,,0.287,241,318,-77
418,VancouverCanucks,1990,28,43,,0.35,243,315,-72
419,WashingtonCapitals,1990,37,36,,0.463,258,258,0
420,WinnipegJets,1990,26,43,,0.325,260,288,-28
421,BostonBruins,1991,36,32,,0.45,270,275,-5
422,BuffaloSabres,1991,31,37,,0.388,289,299,-10
423,CalgaryFlames,1991,31,37,,0.388,296,305,-9
424,ChicagoBlackhawks,1991,36,29,,0.45,257,236,21
425,BostonBruins,1990,44,24,,0.55,299,264,35
426,BuffaloSabres,1990,31,30,,0.388,292,278,14
427,CalgaryFlames,1990,46,26,,0.575,344,263,81
428,ChicagoBlackhawks,1990,49,23,,0.613,284,211,73
429,DetroitRedWings,1990,34,38,,0.425,273,298,-25
430,EdmontonOilers,1990,37,37,,0.463,272,272,0
431,HartfordWhalers,1990,31,38,,0.388,238,276,-38
432,LosAngelesKings,1990,46,24,,0.575,340,254,86
433,MinnesotaNorthStars,1990,27,39,,0.338,256,266,-10
434,MontrealCanadiens,1990,39,30,,0.487,273,249,24
435,NewJerseyDevils,1990,32,33,,0.4,272,264,8
436,NewYorkIslanders,1990,25,45,,0.312,223,290,-67
437,NewYorkRangers,1990,36,31,,0.45,297,265,32
438,PhiladelphiaFlyers,1990,33,37,,0.412,252,267,-15
439,PittsburghPenguins,1990,41,33,,0.512,342,305,37
440,QuebecNordiques,1990,16,50,,0.2,236,354,-118
441,St.LouisBlues,1990,47,22,,0.588,310,250,60
442,TorontoMapleLeafs,1990,23,46,,0.287,241,318,-77
443,VancouverCanucks,1990,28,43,,0.35,243,315,-72
444,WashingtonCapitals,1990,37,36,,0.463,258,258,0
445,WinnipegJets,1990,26,43,,0.325,260,288,-28
446,BostonBruins,1991,36,32,,0.45,270,275,-5
447,BuffaloSabres,1991,31,37,,0.388,289,299,-10
448,CalgaryFlames,1991,31,37,,0.388,296,305,-9
449,ChicagoBlackhawks,1991,36,29,,0.45,257,236,21
450,BostonBruins,1990,44,24,,0.55,299,264,35
451,BuffaloSabres,1990,31,30,,0.388,292,278,14
452,CalgaryFlames,1990,46,26,,0.575,344,263,81
453,ChicagoBlackhawks,1990,49,23,,0.613,284,211,73
454,DetroitRedWings,1990,34,38,,0.425,273,298,-25
455,EdmontonOilers,1990,37,37,,0.463,272,272,0
456,HartfordWhalers,1990,31,38,,0.388,238,276,-38
457,LosAngelesKings,1990,46,24,,0.575,340,254,86
458,MinnesotaNorthStars,1990,27,39,,0.338,256,266,-10
459,MontrealCanadiens,1990,39,30,,0.487,273,249,24
460,NewJerseyDevils,1990,32,33,,0.4,272,264,8
461,NewYorkIslanders,1990,25,45,,0.312,223,290,-67
462,NewYorkRangers,1990,36,31,,0.45,297,265,32
463,PhiladelphiaFlyers,1990,33,37,,0.412,252,267,-15
464,PittsburghPenguins,1990,41,33,,0.512,342,305,37
465,QuebecNordiques,1990,16,50,,0.2,236,354,-118
466,St.LouisBlues,1990,47,22,,0.588,310,250,60
467,TorontoMapleLeafs,1990,23,46,,0.287,241,318,-77
468,VancouverCanucks,1990,28,43,,0.35,243,315,-72
469,WashingtonCapitals,1990,37,36,,0.463,258,258,0
470,WinnipegJets,1990,26,43,,0.325,260,288,-28
471,BostonBruins,1991,36,32,,0.45,270,275,-5
472,BuffaloSabres,1991,31,37,,0.388,289,299,-10
473,CalgaryFlames,1991,31,37,,0.388,296,305,-9
474,ChicagoBlackhawks,1991,36,29,,0.45,257,236,21
475,BostonBruins,1990,44,24,,0.55,299,264,35
476,BuffaloSabres,1990,31,30,,0.388,292,278,14
477,CalgaryFlames,1990,46,26,,0.575,344,263,81
478,ChicagoBlackhawks,1990,49,23,,0.613,284,211,73
479,DetroitRedWings,1990,34,38,,0.425,273,298,-25
480,EdmontonOilers,1990,37,37,,0.463,272,272,0
481,HartfordWhalers,1990,31,38,,0.388,238,276,-38
482,LosAngelesKings,1990,46,24,,0.575,340,254,86
483,MinnesotaNorthStars,1990,27,39,,0.338,256,266,-10
484,MontrealCanadiens,1990,39,30,,0.487,273,249,24
485,NewJerseyDevils,1990,32,33,,0.4,272,264,8
486,NewYorkIslanders,1990,25,45,,0.312,223,290,-67
487,NewYorkRangers,1990,36,31,,0.45,297,265,32
488,PhiladelphiaFlyers,1990,33,37,,0.412,252,267,-15
489,PittsburghPenguins,1990,41,33,,0.512,342,305,37
490,QuebecNordiques,1990,16,50,,0.2,236,354,-118
491,St.LouisBlues,1990,47,22,,0.588,310,250,60
492,TorontoMapleLeafs,1990,23,46,,0.287,241,318,-77
493,VancouverCanucks,1990,28,43,,0.35,243,315,-72
494,WashingtonCapitals,1990,37,36,,0.463,258,258,0
495,WinnipegJets,1990,26,43,,0.325,260,288,-28
496,BostonBruins,1991,36,32,,0.45,270,275,-5
497,BuffaloSabres,1991,31,37,,0.388,289,299,-10
498,CalgaryFlames,1991,31,37,,0.388,296,305,-9
499,ChicagoBlackhawks,1991,36,29,,0.45,257,236,21
500,BostonBruins,1990,44,24,,0.55,299,264,35
501,BuffaloSabres,1990,31,30,,0.388,292,278,14
502,CalgaryFlames,1990,46,26,,0.575,344,263,81
503,ChicagoBlackhawks,1990,49,23,,0.613,284,211,73
504,DetroitRedWings,1990,34,38,,0.425,273,298,-25
505,EdmontonOilers,1990,37,37,,0.463,272,272,0
506,HartfordWhalers,1990,31,38,,0.388,238,276,-38
507,LosAngelesKings,1990,46,24,,0.575,340,254,86
508,MinnesotaNorthStars,1990,27,39,,0.338,256,266,-10
509,MontrealCanadiens,1990,39,30,,0.487,273,249,24
510,NewJerseyDevils,1990,32,33,,0.4,272,264,8
511,NewYorkIslanders,1990,25,45,,0.312,223,290,-67
512,NewYorkRangers,1990,36,31,,0.45,297,265,32
513,PhiladelphiaFlyers,1990,33,37,,0.412,252,267,-15
514,PittsburghPenguins,1990,41,33,,0.512,342,305,37
515,QuebecNordiques,1990,16,50,,0.2,236,354,-118
516,St.LouisBlues,1990,47,22,,0.588,310,250,60
517,TorontoMapleLeafs,1990,23,46,,0.287,241,318,-77
518,VancouverCanucks,1990,28,43,,0.35,243,315,-72
519,WashingtonCapitals,1990,37,36,,0.463,258,258,0
520,WinnipegJets,1990,26,43,,0.325,260,288,-28
521,BostonBruins,1991,36,32,,0.45,270,275,-5
522,BuffaloSabres,1991,31,37,,0.388,289,299,-10
523,CalgaryFlames,1991,31,37,,0.388,296,305,-9
524,ChicagoBlackhawks,1991,36,29,,0.45,257,236,21
525,BostonBruins,1990,44,24,,0.55,299,264,35
526,BuffaloSabres,1990,31,30,,0.388,292,278,14
527,CalgaryFlames,1990,46,26,,0.575,344,263,81
528,ChicagoBlackhawks,1990,49,23,,0.613,284,211,73
529,DetroitRedWings,1990,34,38,,0.425,273,298,-25
530,EdmontonOilers,1990,37,37,,0.463,272,272,0
531,HartfordWhalers,1990,31,38,,0.388,238,276,-38
532,LosAngelesKings,1990,46,24,,0.575,340,254,86
533,MinnesotaNorthStars,1990,27,39,,0.338,256,266,-10
534,MontrealCanadiens,1990,39,30,,0.487,273,249,24
535,NewJerseyDevils,1990,32,33,,0.4,272,264,8
536,NewYorkIslanders,1990,25,45,,0.312,223,290,-67
537,NewYorkRangers,1990,36,31,,0.45,297,265,32
538,PhiladelphiaFlyers,1990,33,37,,0.412,252,267,-15
539,PittsburghPenguins,1990,41,33,,0.512,342,305,37
540,QuebecNordiques,1990,16,50,,0.2,236,354,-118
541,St.LouisBlues,1990,47,22,,0.588,310,250,60
542,TorontoMapleLeafs,1990,23,46,,0.287,241,318,-77
543,VancouverCanucks,1990,28,43,,0.35,243,315,-72
544,WashingtonCapitals,1990,37,36,,0.463,258,258,0
545,WinnipegJets,1990,26,43,,0.325,260,288,-28
546,BostonBruins,1991,36,32,,0.45,270,275,-5
547,BuffaloSabres,1991,31,37,,0.388,289,299,-10
548,CalgaryFlames,1991,31,37,,0.388,296,305,-9
549,ChicagoBlackhawks,1991,36,29,,0.45,257,236,21
550,BostonBruins,1990,44,24,,0.55,299,264,35
551,BuffaloSabres,1990,31,30,,0.388,292,278,14
552,CalgaryFlames,1990,46,26,,0.575,344,263,81
553,ChicagoBlackhawks,1990,49,23,,0.613,284,211,73
554,DetroitRedWings,1990,34,38,,0.425,273,298,-25
555,EdmontonOilers,1990,37,37,,0.463,272,272,0
556,HartfordWhalers,1990,31,38,,0.388,238,276,-38
557,LosAngelesKings,1990,46,24,,0.575,340,254,86
558,MinnesotaNorthStars,1990,27,39,,0.338,256,266,-10
559,MontrealCanadiens,1990,39,30,,0.487,273,249,24
560,NewJerseyDevils,1990,32,33,,0.4,272,264,8
561,NewYorkIslanders,1990,25,45,,0.312,223,290,-67
562,NewYorkRangers,1990,36,31,,0.45,297,265,32
563,PhiladelphiaFlyers,1990,33,37,,0.412,252,267,-15
564,PittsburghPenguins,1990,41,33,,0.512,342,305,37
565,QuebecNordiques,1990,16,50,,0.2,236,354,-118
566,St.LouisBlues,1990,47,22,,0.588,310,250,60
567,TorontoMapleLeafs,1990,23,46,,0.287,241,318,-77
568,VancouverCanucks,1990,28,43,,0.35,243,315,-72
569,WashingtonCapitals,1990,37,36,,0.463,258,258,0
570,WinnipegJets,1990,26,43,,0.325,260,288,-28
571,BostonBruins,1991,36,32,,0.45,270,275,-5
572,BuffaloSabres,1991,31,37,,0.388,289,299,-10
573,CalgaryFlames,1991,31,37,,0.388,296,305,-9
574,ChicagoBlackhawks,1991,36,29,,0.45,257,236,21
575,BostonBruins,1990,44,24,,0.55,299,264,35
576,BuffaloSabres,1990,31,30,,0.388,292,278,14
577,CalgaryFlames,1990,46,26,,0.575,344,263,81
578,ChicagoBlackhawks,1990,49,23,,0.613,284,211,73
579,DetroitRedWings,1990,34,38,,0.425,273,298,-25
580,EdmontonOilers,1990,37,37,,0.463,272,272,0
581,HartfordWhalers,1990,31,38,,0.388,238,276,-38
582,LosAngelesKings,1990,46,24,,0.575,340,254,86
583,MinnesotaNorthStars,1990,27,39,,0.338,256,266,-10
584,MontrealCanadiens,1990,39,30,,0.487,273,249,24
585,NewJerseyDevils,1990,32,33,,0.4,272,264,8
586,NewYorkIslanders,1990,25,45,,0.312,223,290,-67
587,NewYorkRangers,1990,36,31,,0.45,297,265,32
588,PhiladelphiaFlyers,1990,33,37,,0.412,252,267,-15
589,PittsburghPenguins,1990,41,33,,0.512,342,305,37
590,QuebecNordiques,1990,16,50,,0.2,236,354,-118
591,St.LouisBlues,1990,47,22,,0.588,310,250,60
592,TorontoMapleLeafs,1990,23,46,,0.287,241,318,-77
593,VancouverCanucks,1990,28,43,,0.35,243,315,-72
594,WashingtonCapitals,1990,37,36,,0.463,258,258,0
595,WinnipegJets,1990,26,43,,0.325,260,288,-28
596,BostonBruins,1991,36,32,,0.45,270,275,-5
597,BuffaloSabres,1991,31,37,,0.388,289,299,-10
598,CalgaryFlames,1991,31,37,,0.388,296,305,-9
599,ChicagoBlackhawks,1991,36,29,,0.45,257,236,21
